.........................,....................................................
..........................,...................................................
.........T.................,.............................I.II.................
............T..............,...........................I.....I................	some trees
.........T...TT...........,...................................I...............	stonehenge
.........................,..............................I....I................
.............#####......,.................................I...................
.............#:::#.....,......................................................
.............#:::#....,................................==..................===	house
.............##+##...,..............................======.........==========.	water
...............,....,.............................===================.........	
................,,,,.............................===============..............
..................................................============................
.....................................................=======..................
....^.........................................................................
.....^........................................................................
^...^..................T......................................................
^^^^^.........................................................................
^^^...........................................................................	mountains
^^^^^^.^......................................................................